19 14
###################
#....#..#.........#
#....#........#.#.#
#.#####.####.##.#.#
#.#.....#.....#.#.#
#.....#.#.......#.#
#.#...#.#..#..#.#.#
#.###.#.#.....#.#.#
#.......#.....#.#.#
###.#######.###.#.#
#......#........#.#
#.#....#.....#....#
#.##..............#
###################